...........................................................
..........X....................................X...........
..........X....................................X...........
..........X....................................X...........
..........X....................................X...........
..........X....................................X...........
..........X....................................X...........
..........XXXXXXXXXXXXXXXXXXXXXXXXXXXXXXXXXXXXXX...........
...........................................................
