..........X......X.......................X.....XX..........
..........X......X.......................X.....XX..........
..........X......X.......X..XXXX..X......X.....XX..........
..........X..............X........X............XX..........
..........X..............X........X............XX..........
..........X..............X..XXXX..X............XX..........
..........X......X.......................X.....XX..........
..........X......X.......................X.....XX..........
..........X......X.......................X.....XX..........
